NO resources/textures/1.png
SO resources/textures/2.png
WE resources/textures/3.png
EA resources/textures/5.png

C 0,0,0
F 97,144,0

           11111111111111111111111111
           11000000000000000000000001
           110L0001000000000000000001
           1000000000000000LL00000001
111111111111000001110000111111111111
1000000000110000011101001
100L000000000000110101001
1100000111010101111101101
1100000111010101111101101
1100000111010101111101101
1000000111110000000000EL1
1011000001110000010000001
1001001100000000000000001
1110001110110000011100001
1000000000110000011101001
1000000000000000110101001
1100000111010101111101101
1111111111111111111111111
