NO resources/textures/1.png
SO resources/textures/2.png
WE resources/textures/3.png
EA resources/textures/5.png

C 0,0,0
F 97,144,0


111111111111111111111111                                   111111111111111111111111
10N000000000000000000001                                   100000000000000000000001
111111111111000000000001                                   111111111111000000000001
           1000000000001                                              1000000000001
111111111111000000000001                                   111111111111000000000001
100000000000000000000001                                   100000000000000000000001
100000000000111111111111                                   100000000000111111111111
100000000001                                               100000000001
100000000000111111111111                                   100000000000111111111111
100000000000000000000001                                   100000000000000000000001
111111111111111111111111                                   111111111111111111111111
