NO resources/textures/1.png
SO resources/textures/2.png
WE resources/textures/3.png
EA resources/textures/5.png

C 0,0,0
F 97,144,0

           11111111111111111111111111
           11000000000000000000000001
           11000001000000000000000001
           10000000000000000000000001
1111111111110000011100001111111111111
1000000000110000011101001
1000000000000000110101001
1100000111010101111101101
1100000111010101111101101
1100000111010101111101101
1000000111110000000000S01
1011000001110000010000001
1001001100000000000000001
1110001110110000011100001
1000000000110000011101001
1000000000000000110101001
1100000111010101111101101
1111111111111111111111111
