NO resources/textures/1.png
SO resources/textures/2.png
WE resources/textures/3.png
EA resources/textures/5.png

C 0,0,0
F 97,144,0

11111111111
10000111111              0
10000111111             0E0
11111111111              0
11111111111
