NO resources/textures/1.png
SO resources/textures/2.png
WE resources/textures/3.png
EA resources/textures/5.png

C 0,0,0
F 97,144,0

11111
10001
10N01
10001
11111
