NO resources/textures/1.png
SO resources/textures/2.png
WE resources/textures/3.png
EA resources/textures/5.png

F 97,144,0
C 0,0,0

1111111
1000001
1000N01
1001001
1111111
